#####
#.#X#
#.#.#
#...#
#####