#######
#.....#
#####.#
#..X#.#
#####.#
#.....#
#.##..#
#..##.#
##.#..#
#..#.##
#..#..#
#######