#######
#.....#
#.###.#
#..X#.#
#####.#
#.....#
#######