#####
#.#X#
#.#.#
#.A.#
#####