#######
#.....#
#.###.#
#..X#.#
#A###.#
#.....#
#.@#..#
#..#..#
#..#..#
#..#..#
#.....#
#######